########
#      #
# PXO  #
#      #
########
